|-----------------------------------------------------------------------------|
|                                                                             |
|                                                                             |
|                                                                             |
|                                                                             |
|                                                                             |
|           /-------|\    /-------|\   |-------\     |----|\  /----\          |
|          /        ||   /        ||   |++++++++|    |    || /    /|          |
|         |   /-----||  |   /-----||   |----\+++|    |    ||/    //           |
|         |   |/-----/  |   |/-----/        |+++|    |    |/    //            |
|         |   ||        |   ||         |----/+++|    |         //             |
|         |   ||        |   ||         |++++++++|    |        |/              |
|         |   ||        |   ||         |++++++++|    |         \              |
|         |   ||        |   ||         |----\+++|    |    |\    \             |
|         |   \-----|\  |   \-----|\        |+++|    |    ||\    \            |
|          \        ||   \        ||   |----/+++|    |    || \    \           |
            \-------||    \-------||   |++++++++/    |----||  \----/|         |
|            \-------/     \-------/   |-------/      \----/   \----/         |
|                                                                             |
|                                                                             |
|                                                                             |
|                                                                             |
|                                                                             |
|                                                                             |
|-----------------------------------------------------------------------------|
